............
.S--------7.
.|F------7|.
.||......||.
.||......||.
.|L--7F--J|.
.|...||...|.
.|...||...|.
.|...||...|.
.L---JL---J.
............